
authorname:留下你的大名&mapname:level：2&mappwd:123&creationtime:2019-12-15 20:02:21&tips:说说你创作的地图特点&barcount:2&levelorder:2&crossnodecount:8
&关卡信息与关卡地图数据分割符&
bari:17&barj:24&barwidth:1&barheight:5&bardir:2&barwide:2&barspeed:400&&bari:17&barj:31&barwidth:1&barheight:5&bardir:3&barwide:2&barspeed:400
&关卡信息与关卡地图数据分割符&
foodlength:12
&关卡信息与关卡地图数据分割符&
snnode:2&snmapi:6,5&snmapj:5,5&snmapdirection:1&&snnode:2&snmapi:37,38&snmapj:55,55&snmapdirection:0
&关卡信息与关卡地图数据分割符&
firstpos:6,7&secondpos:13,18&&firstpos:13,28&secondpos:6,28&&firstpos:6,50&secondpos:13,38&&firstpos:19,50&secondpos:19,38&&firstpos:26,38&secondpos:34,50&&firstpos:34,28&secondpos:26,28&&firstpos:34,7&secondpos:26,18&&firstpos:19,7&secondpos:19,18&&firstpos:6,7&secondpos:13,18&&firstpos:13,28&secondpos:6,28&&firstpos:6,50&secondpos:13,38&&firstpos:19,50&secondpos:19,38&&firstpos:26,38&secondpos:34,50&&firstpos:34,28&secondpos:26,28&&firstpos:34,7&secondpos:26,18&&firstpos:19,7&secondpos:19,18
&关卡信息与关卡地图数据分割符&
111111111111111111111111111111111111111111111111111111111111
100000000000000001000000000000000000000100000000000000000001
100000000000000001000000000000000000000100000000000000000001
100000000000000001000000000000000000000100000000000000000001
100000000000000001000000000000000000000100000000000000000001
100002000000000001000000000000000000000100000000000000000001
100002000000000001000000000000000000000100000000000000000001
100000000000000001000000000000000000000100000000000000000001
100000000000000001000000000000000000000100000000000000000001
100000000000000001000000000000000000000100000000000000000001
100000000000000001000000000000000000000100000000000000000001
100000000000000001000000000000000000000100000000000000000001
111111111111111111111111111111111111111111111111111111111111
100000000000000001000000000000000000000100000000000000000001
100000000000000001000000000000000000000100000000000000000001
100000000000000001000000000000000000000100000000000000000001
100000000000000001000000111111110000000100000000000000000001
100000000000000001000000h000000h0000000100000000000000000001
100000000000000001000000h000000h0000000100000000000000000001
100000000000000001000000h000000h0000000100000000000000000001
100000000000000001000000h000000h0000000100000000000000000001
100000000000000001000000h000000h0000000100000000000000000001
100000000000000001000000111111110000000100000000000000000001
100000000000000001000000000000000000000100000000000000000001
100000000000000001000000000000000000000100000000000000000001
100000000000000001000000000000000000000100000000000000000001
100000000000000001000000000000000000000100000000000000000001
111111111111111111111111111111111111111111111111111111111111
100000000000000001000000000000000000000100000000000000000001
100000000000000001000000000000000000000100000000000000000001
100000000000000001000000000000000000000100000000000000000001
100000000000000001000000000000000000000100000000000000000001
100000000000000001000000000000000000000100000000000000000001
100000000000000001000000000000000000000100000000000000000001
100000000000000001000000000000000000000100000000000000000001
100000000000000001000000000000000000000100000000000000000001
100000000000000001000000000000000000000100000000000000000001
100000000000000001000000000000000000000100000000000000030001
100000000000000001000000000000000000000100000000000000030001
100000000000000001000000000000000000000100000000000000000001
111111111111111111111111111111111111111111111111111111111111
&关卡与关卡分割符&
authorname:留下你的大名&mapname:level：3&mappwd:123&creationtime:2019-12-15 20:11:09&tips:说说你创作的地图特点&barcount:2&levelorder:3&crossnodecount:0
&关卡信息与关卡地图数据分割符&
bari:8&barj:10&barwidth:10&barheight:4&bardir:0&barwide:4&barspeed:200&&bari:17&barj:43&barwidth:3&barheight:4&bardir:1&barwide:5&barspeed:300
&关卡信息与关卡地图数据分割符&
foodlength:2
&关卡信息与关卡地图数据分割符&
snnode:2&snmapi:6,5&snmapj:5,5&snmapdirection:1&&snnode:2&snmapi:37,38&snmapj:55,55&snmapdirection:0
&关卡信息与关卡地图数据分割符&

&关卡信息与关卡地图数据分割符&
000000000000000000000000000000000000000000000000000000000000
000000000000000000000000000000000000000000000000000000000000
000000000000000000000000000000000000000000000000000000000000
000000000000000000000000000000000000000000000000000000000000
000000000000000000000000000000000000000000000000000000000000
000002000000000000000000000000000000000000000000000000000000
000002000000000000000000000000000000000000000000000000000000
000000000000000000000000000000000000000000000000000000000000
0000000000hhhhhhhhhh0000000000000000000000000000000000000000
0000000000hhhhhhhhhh0000000000000000000000000000000000000000
0000000000hhhhhhhhhh0000000000000000000000000000000000000000
0000000000hhhhhhhhhh0000000000000000000000000000000000000000
000000000000000000000000000000000000000000000000000000000000
000000000000000000000000000000000000000000000000000000000000
000000000000000000000000000000000000000000000000000000000000
000000000000000000000000000000000000000000000000000000000000
000000000000000000000000000000000000000000000000000000000000
0000000000000000000000000000000000000000000hhh00000000000000
0000000000000000000000000000000000000000000hhh00000000000000
0000000000000000000000000000000000000000000hhh00000000000000
0000000000000000000000000000000000000000000hhh00000000000000
000000000000000000000000000000000000000000000000000000000000
000000000000000000000000000000000000000000000000000000000000
000000000000000000000000000000000000000000000000000000000000
000000000000000000000000000000000000000000000000000000000000
000000000000000000000000000000000000000000000000000000000000
000000000000000000000000000000000000000000000000000000000000
000000000000000000000000000000000000000000000000000000000000
000000000000000000000000000000000000000000000000000000000000
000000000000000000000000000000000000000000000000000000000000
000000000000000000000000000000000000000000000000000000000000
000000000000000000000000000000000000000000000000000000000000
000000000000000000000000000000000000000000000000000000000000
000000000000000000000000000000000000000000000000000000000000
000000000000000000000000000000000000000000000000000000000000
000000000000000000000000000000000000000000000000000000000000
000000000000000000000000000000000000000000000000000000000000
000000000000000000000000000000000000000000000000000000030000
000000000000000000000000000000000000000000000000000000030000
000000000000000000000000000000000000000000000000000000000000
000000000000000000000000000000000000000000000000000000000000
&关卡与关卡分割符&
authorname:留下你的大名&mapname:level：4&mappwd:123&creationtime:2019-12-15 20:13:05&tips:说说你创作的地图特点&barcount:2&levelorder:4&crossnodecount:0
&关卡信息与关卡地图数据分割符&
bari:6&barj:27&barwidth:12&barheight:6&bardir:0&barwide:3&barspeed:200&&bari:22&barj:43&barwidth:6&barheight:4&bardir:0&barwide:4&barspeed:500
&关卡信息与关卡地图数据分割符&
foodlength:2
&关卡信息与关卡地图数据分割符&
snnode:2&snmapi:6,5&snmapj:5,5&snmapdirection:1&&snnode:2&snmapi:37,38&snmapj:55,55&snmapdirection:0
&关卡信息与关卡地图数据分割符&

&关卡信息与关卡地图数据分割符&
000000000000000000000000000000000000000000000000000000000000
000000000000000000000000000000000000000000000000000000000000
000000000000000000000000000000000000000000000000000000000000
000000000000000000000000000000000000000000000000000000000000
000000000000000000000000000000000000000000000000000000000000
000002000000000000000000000000000000000000000000000000000000
000002000000000000000000000hhhhhhhhhhhh000000000000000000000
000000000000000000000000000hhhhhhhhhhhh000000000000000000000
000000000000000000000000000hhhhhhhhhhhh000000000000000000000
000000000000000000000000000hhhhhhhhhhhh000000000000000000000
000000000000000000000000000hhhhhhhhhhhh000000000000000000000
000000000000000000000000000hhhhhhhhhhhh000000000000000000000
000000000000000000000000000000000000000000000000000000000000
000000000000000000000000000000000000000000000000000000000000
000000000000000000000000000000000000000000000000000000000000
000000000000000000000000000000000000000000000000000000000000
000000000000000000000000000000000000000000000000000000000000
000000000000000000000000000000000000000000000000000000000000
000000000000000000000000000000000000000000000000000000000000
000000000000000000000000000000000000000000000000000000000000
000000000000000000000000000000000000000000000000000000000000
000000000000000000000000000000000000000000000000000000000000
0000000000000000000000000000000000000000000hhhhhh00000000000
0000000000000000000000000000000000000000000hhhhhh00000000000
0000000000000000000000000000000000000000000hhhhhh00000000000
0000000000000000000000000000000000000000000hhhhhh00000000000
000000000000000000000000000000000000000000000000000000000000
000000000000000000000000000000000000000000000000000000000000
000000000000000000000000000000000000000000000000000000000000
000000000000000000000000000000000000000000000000000000000000
000000000000000000000000000000000000000000000000000000000000
000000000000000000000000000000000000000000000000000000000000
000000000000000000000000000000000000000000000000000000000000
000000000000000000000000000000000000000000000000000000000000
000000000000000000000000000000000000000000000000000000000000
000000000000000000000000000000000000000000000000000000000000
000000000000000000000000000000000000000000000000000000000000
000000000000000000000000000000000000000000000000000000030000
000000000000000000000000000000000000000000000000000000030000
000000000000000000000000000000000000000000000000000000000000
000000000000000000000000000000000000000000000000000000000000
&关卡与关卡分割符&
authorname:留下你的大名&mapname:level：5&mappwd:123&creationtime:2019-12-16 17:25:46&tips:说说你创作的地图特点&barcount:0&levelorder:5&crossnodecount:2
&关卡信息与关卡地图数据分割符&

&关卡信息与关卡地图数据分割符&
foodlength:2
&关卡信息与关卡地图数据分割符&
snnode:2&snmapi:2,1&snmapj:18,18&snmapdirection:1&&snnode:2&snmapi:37,38&snmapj:55,55&snmapdirection:0
&关卡信息与关卡地图数据分割符&
firstpos:28,30&secondpos:24,26&&firstpos:28,19&secondpos:24,18
&关卡信息与关卡地图数据分割符&
000000000000000000000000000000000000000000000000000000000000
000000000000000000200000000000000000000000000000000000000000
000000001000000000200000000000000000000000000000000000000000
000000001000000000000000000000000000000000000000000000000000
000000001000000000000000000000000000000000000000000000000000
000000001000011111111111111111111111111111111111111000000000
000000001000000000000000000000000000000000000000000000000100
000000001000000000000000000000000000000000000000000000000100
000000001000000000000000000000000000000000000000000000000100
000000001000000000000000000000000000000000000000000000000100
000000001000000000000000000000000001111111111111111100000100
000000001000000000000000000000000000000000000000000000000100
000000001000000000000001111111111000000000000000000000000100
000000001000000000000000000000000000000000000000000000000100
000000001000000000000000000000000000000000000000000000000100
000000001001000000000000000000000000000000000000000000000100
000000001001000000000000000000000000000000000000000000000100
000000001001000000000000000000000000000000000000000000000100
000000001001000000000000000000000000000000001111111111110100
000000001001000000000000000000000000000000000000000000000100
000000001001000000000000000000000000000000000000000000000000
000000001001000000000000000000000000000000000000000000000000
000000001001000000000000000000000000000000000000000000000000
000000001001000000000000000000000000000000000000000000000000
000000001001000000000000000000000000000000000000000000000000
000000001001000000000000000000000000000000000011111111111110
000000001001000000000000000000000000000100000011111111111110
000000001001000000000000000000000000000100000000000000000000
000000001001000000000000000000000000000100000000000000000000
000000001001000000000000000000000000000100000000000000000000
000000001001000000000000000000000000000100000000000000000000
000000001001000000000000000000000000000100000000000100000000
000000001001000000000000000000000000000100000000000100000010
000000001001000000000010000000000000000100000000000100000010
000000001001000000000000000000000000000100000000000100000010
000000001001000000000000000000000000000100000000000100000010
000000001001000000000000000000000000000100000000000100000010
000000001001000000000000000000000000000000000000000100030010
000000001000000000000000000000000000000000000000000100030010
000000001000000001111111111111111111111111111111000100000000
000000000000000000000000000000000000000000000000000000000000
&关卡与关卡分割符&
authorname:留下你的大名&mapname:level：6&mappwd:123&creationtime:2019-12-16 20:18:52&tips:说说你创作的地图特点&barcount:1&levelorder:6&crossnodecount:0
&关卡信息与关卡地图数据分割符&
bari:4&barj:7&barwidth:46&barheight:36&bardir:0&barwide:4&barspeed:400
&关卡信息与关卡地图数据分割符&
foodlength:15
&关卡信息与关卡地图数据分割符&
snnode:2&snmapi:6,5&snmapj:5,5&snmapdirection:1&&snnode:2&snmapi:37,38&snmapj:55,55&snmapdirection:0
&关卡信息与关卡地图数据分割符&

&关卡信息与关卡地图数据分割符&
000000000000000000000000000000000000000000000000000000000000
000000000000000000000000000000000000000000000000000000000000
000000000000000000000000000000000000000000000000000000000000
000000000000000000000000000000000000000000000000000000000000
0000000hhhhhhhhhhhhhhhhhhhhhhhhhhhhhhhhhhhhhhhhhhhhhh0000000
0000020hhhhhhhhhhhhhhhhhhhhhhhhhhhhhhhhhhhhhhhhhhhhhh0000000
0000020hhhhhhhhhhhhhhhhhhhhhhhhhhhhhhhhhhhhhhhhhhhhhh0000000
0000000hhhhhhhhhhhhhhhhhhhhhhhhhhhhhhhhhhhhhhhhhhhhhh0000000
0000000hhhhhhhhhhhhhhhhhhhhhhhhhhhhhhhhhhhhhhhhhhhhhh0000000
0000000hhhhhhhhhhhhhhhhhhhhhhhhhhhhhhhhhhhhhhhhhhhhhh0000000
0000000hhhhhhhhhhhhhhhhhhhhhhhhhhhhhhhhhhhhhhhhhhhhhh0000000
0000000hhhhhhhhhhhhhhhhhhhhhhhhhhhhhhhhhhhhhhhhhhhhhh0000000
0000000hhhhhhhhhhhhhhhhhhhhhhhhhhhhhhhhhhhhhhhhhhhhhh0000000
0000000hhhhhhhhhhhhhhhhhhhhhhhhhhhhhhhhhhhhhhhhhhhhhh0000000
0000000hhhhhhhhhhhhhhhhhhhhhhhhhhhhhhhhhhhhhhhhhhhhhh0000000
0000000hhhhhhhhhhhhhhhhhhhhhhhhhhhhhhhhhhhhhhhhhhhhhh0000000
0000000hhhhhhhhhhhhhhhhhhhhhhhhhhhhhhhhhhhhhhhhhhhhhh0000000
0000000hhhhhhhhhhhhhhhhhhhhhhhhhhhhhhhhhhhhhhhhhhhhhh0000000
0000000hhhhhhhhhhhhhhhhhhhhhhhhhhhhhhhhhhhhhhhhhhhhhh0000000
0000000hhhhhhhhhhhhhhhhhhhhhhhhhhhhhhhhhhhhhhhhhhhhhh0000000
0000000hhhhhhhhhhhhhhhhhhhhhhhhhhhhhhhhhhhhhhhhhhhhhh0000000
0000000hhhhhhhhhhhhhhhhhhhhhhhhhhhhhhhhhhhhhhhhhhhhhh0000000
0000000hhhhhhhhhhhhhhhhhhhhhhhhhhhhhhhhhhhhhhhhhhhhhh0000000
0000000hhhhhhhhhhhhhhhhhhhhhhhhhhhhhhhhhhhhhhhhhhhhhh0000000
0000000hhhhhhhhhhhhhhhhhhhhhhhhhhhhhhhhhhhhhhhhhhhhhh0000000
0000000hhhhhhhhhhhhhhhhhhhhhhhhhhhhhhhhhhhhhhhhhhhhhh0000000
0000000hhhhhhhhhhhhhhhhhhhhhhhhhhhhhhhhhhhhhhhhhhhhhh0000000
0000000hhhhhhhhhhhhhhhhhhhhhhhhhhhhhhhhhhhhhhhhhhhhhh0000000
0000000hhhhhhhhhhhhhhhhhhhhhhhhhhhhhhhhhhhhhhhhhhhhhh0000000
0000000hhhhhhhhhhhhhhhhhhhhhhhhhhhhhhhhhhhhhhhhhhhhhh0000000
0000000hhhhhhhhhhhhhhhhhhhhhhhhhhhhhhhhhhhhhhhhhhhhhh0000000
0000000hhhhhhhhhhhhhhhhhhhhhhhhhhhhhhhhhhhhhhhhhhhhhh0000000
0000000hhhhhhhhhhhhhhhhhhhhhhhhhhhhhhhhhhhhhhhhhhhhhh0000000
0000000hhhhhhhhhhhhhhhhhhhhhhhhhhhhhhhhhhhhhhhhhhhhhh0000000
0000000hhhhhhhhhhhhhhhhhhhhhhhhhhhhhhhhhhhhhhhhhhhhhh0000000
0000000hhhhhhhhhhhhhhhhhhhhhhhhhhhhhhhhhhhhhhhhhhhhhh0000000
0000000hhhhhhhhhhhhhhhhhhhhhhhhhhhhhhhhhhhhhhhhhhhhhh0000000
0000000hhhhhhhhhhhhhhhhhhhhhhhhhhhhhhhhhhhhhhhhhhhhhh0030000
0000000hhhhhhhhhhhhhhhhhhhhhhhhhhhhhhhhhhhhhhhhhhhhhh0030000
0000000hhhhhhhhhhhhhhhhhhhhhhhhhhhhhhhhhhhhhhhhhhhhhh0000000
000000000000000000000000000000000000000000000000000000000000
&关卡与关卡分割符&
authorname:留下你的大名&mapname:level：15&mappwd:123&creationtime:2019-12-2 12:40:12&tips:说说你创作的地图特点&barcount:0&levelorder:15&crossnodecount:0
&关卡信息与关卡地图数据分割符&

&关卡信息与关卡地图数据分割符&
foodlength:14
&关卡信息与关卡地图数据分割符&
snnode:2&snmapi:6,5&snmapj:5,5&snmapdirection:1&&snnode:2&snmapi:37,38&snmapj:55,55&snmapdirection:0
&关卡信息与关卡地图数据分割符&

&关卡信息与关卡地图数据分割符&
000000000000000000000000000111111000000000000000000000000000
000000000000000000000000000111111000000000000000000000000000
000000000000000000000000000111111000000000000000000000000000
000000000000000000000000000111111000000000000000000000000000
000000000000000000000000000111111000000000000000000000000000
000002000000000000000000000111111000000000000000000000000000
000002000000000000000000000111111000000000000000000000000000
000000000000000000000000000111111000000000000000000000000000
000000000000000000000000000111111000000000000000000000000000
000000000000000000000000000111111000000000000000000000000000
000000000000000000000000000111111000000000000000000000000000
000000000000000000000000000111111000000000000000000000000000
000000000000000000000000000111111000000000000000000000000000
000000000000000000000000000111111000000000000000000000000000
000000000000000000000000000111111000000000000000000000000000
000000000000000000000000000111111000000000000000000000000000
000000000000000000000000000111111000000000000000000000000000
000000000000000000000000000111111000000000000000000000000000
000000000000000000000000000111111000000000000000000000000000
111111111111111111111111111111111111111111111111111111111111
111111111111111111111111111111111111111111111111111111111111
111111111111111111111111111111111111111111111111111111111111
000000000000000000000000000111111000000000000000000000000000
000000000000000000000000000111111000000000000000000000000000
000000000000000000000000000111111000000000000000000000000000
000000000000000000000000000111111000000000000000000000000000
000000000000000000000000000111111000000000000000000000000000
000000000000000000000000000111111000000000000000000000000000
000000000000000000000000000111111000000000000000000000000000
000000000000000000000000000111111000000000000000000000000000
000000000000000000000000000111111000000000000000000000000000
000000000000000000000000000111111000000000000000000000000000
000000000000000000000000000111111000000000000000000000000000
000000000000000000000000000111111000000000000000000000000000
000000000000000000000000000111111000000000000000000000000000
000000000000000000000000000111111000000000000000000000000000
000000000000000000000000000111111000000000000000000000000000
000000000000000000000000000111111000000000000000000000030000
000000000000000000000000000111111000000000000000000000030000
000000000000000000000000000111111000000000000000000000000000
000000000000000000000000000111111000000000000000000000000000
&关卡与关卡分割符&
authorname:LIUJIANJIE&mapname:level：7&mappwd:123&creationtime:2019-12-17 15:05:33&tips:说说你创作的地图特点&barcount:0&levelorder:7&crossnodecount:0
&关卡信息与关卡地图数据分割符&

&关卡信息与关卡地图数据分割符&
foodlength:16
&关卡信息与关卡地图数据分割符&
snnode:2&snmapi:21,20&snmapj:9,9&snmapdirection:1&&snnode:2&snmapi:20,21&snmapj:49,49&snmapdirection:0
&关卡信息与关卡地图数据分割符&

&关卡信息与关卡地图数据分割符&
111111111111111111111100000000000000001111111111111111111111
111111111111111111111100000000000000001111111111111111111111
111111111111111111111100000000000000001111111111111111111111
111111111111111111111100000000000000001111111111111111111111
111111111111111111111100000000000000001111111111111111111111
111111111111111111111000000000000000000111111111111111111111
111111111111111111110000000000000000000011111111111111111111
111111111111111111100000000000000000000001111111111111111111
111111111111111111000000000000000000000000111111111111111111
111111111111111110000000000000000000000000011111111111111111
111111111111111100000000000000000000000000001111111111111111
111111111111111000000000000000000000000000000111111111111111
111111111111110000000000000000000000000000000011111111111111
111111111111100000000000000000000000000000000001111111111111
111111111111000000001111111111111111111100000000111111111111
111111111110000000001111111111111111111100000000011111111111
111111111100000000001111111111111111111100000000001111111111
111111111000000000001111111111111111111100000000000111111111
000000000000000000001111111111111111111100000000000000000000
000000000000000000001111111111111111111100000000000000000000
000000000200000000001111111111111111111100000000030000000000
000000000200000000001111111111111111111100000000030000000000
000000000000000000001111111111111111111100000000000000000000
000000000000000000001111111111111111111100000000000000000000
000000000000000000001111111111111111111100000000000000000000
111111111000000000001111111111111111111100000000000111111111
111111111100000000001111111111111111111100000000001111111111
111111111110000000001111111111111111111100000000011111111111
111111111111000000001111111111111111111100000000111111111111
111111111111100000001111111111111111111100000001111111111111
111111111111110000001111111111111111111100000011111111111111
111111111111111000000000000000000000000000000111111111111111
111111111111111100000000000000000000000000001111111111111111
111111111111111110000000000000000000000000011111111111111111
111111111111111111000000000000000000000000111111111111111111
111111111111111111100000000000000000000001111111111111111111
111111111111111111110000000000000000000011111111111111111111
111111111111111111111000000000000000000111111111111111111111
111111111111111111111100000000000000001111111111111111111111
111111111111111111111100000000000000001111111111111111111111
111111111111111111111100000000000000001111111111111111111111
&关卡与关卡分割符&
